# English Elements with Recipes
# Format: TSV - id, name, emoji, parents (empty for base elements)
id	name	emoji	parents
water	Water	ğŸ’§	
fire	Fire	ğŸ”¥	
earth	Earth	ğŸŒ	
air	Air	ğŸŒ¬ï¸	
steam	Steam	ğŸ’¨	water+fire
mud	Mud	ğŸŸ«	water+earth
lava	Lava	ğŸŒ‹	fire+earth
dust	Dust	ğŸŒ«ï¸	air+earth
lightning	Lightning	âš¡	air+fire
cloud	Cloud	â˜ï¸	air+water
stone	Stone	ğŸ—¿	lava+water
energy	Energy	âœ¨	fire+fire
wind	Wind	ğŸƒ	air+air
sea	Sea	ğŸŒŠ	water+water
rain	Rain	ğŸŒ§ï¸	cloud+water
brick	Brick	ğŸ§±	mud+fire
plant	Plant	ğŸŒ±	rain+earth
storm	Storm	â›ˆï¸	cloud+lightning
mountain	Mountain	â›°ï¸	earth+stone
swamp	Swamp	ğŸŠ	plant+mud
metal	Metal	ğŸ”©	stone+fire
sand	Sand	ğŸ–ï¸	stone+wind
glass	Glass	ğŸ”	sand+fire
wave	Wave	ã€°ï¸	sea+wind
tree	Tree	ğŸŒ³	plant+earth
wall	Wall	ğŸ§±	brick+brick
sky	Sky	ğŸŸ¦	cloud+cloud
sun	Sun	â˜€ï¸	sky+fire
forest	Forest	ğŸŒ²	tree+tree
life	Life	ğŸ§¬	swamp+energy
flower	Flower	ğŸŒ¸	plant+sun
blade	Blade	ğŸ”ª	metal+stone
bird	Bird	ğŸ¦	life+sky
fish	Fish	ğŸŸ	life+water
animal	Animal	ğŸ¾	life+earth
clay	Clay	ğŸº	mud+sand
human	Human	ğŸ§‘	life+clay
tool	Tool	ğŸ› ï¸	human+stone
wood	Wood	ğŸªµ	human+tree
farmer	Farmer	ğŸ§‘â€ğŸŒ¾	human+plant
house	House	ğŸ 	wall+wood
warrior	Warrior	âš”ï¸	human+blade
boat	Boat	â›µ	wood+water
wheel	Wheel	ğŸ›	tool+wood
cart	Cart	ğŸ›’	wheel+wood
field	Field	ğŸŒ¾	farmer+earth
livestock	Livestock	ğŸ„	animal+farmer
wool	Wool	ğŸ§¶	livestock+tool
fabric	Fabric	ğŸ‘•	wool+tool
sailor	Sailor	ğŸ§‘â€âœˆï¸	human+boat
city	City	ğŸ™ï¸	house+house