# Spanish Element Names and Emojis
# Format: TSV - id, name, emoji
id	name	emoji
water	Agua	ğŸ’§
fire	Fuego	ğŸ”¥
earth	Tierra	ğŸŒ
air	Aire	ğŸŒ¬ï¸
steam	Vapor	ğŸ’¨
mud	Barro	ğŸŸ«
lava	Lava	ğŸŒ‹
dust	Polvo	ğŸŒ«ï¸
lightning	Rayo	âš¡
cloud	Nube	â˜ï¸
rain	Lluvia	ğŸŒ§ï¸
storm	Tormenta	â›ˆï¸
obsidian	Obsidiana	â¬›
plant	Planta	ğŸŒ±
lake	Lago	ğŸï¸
inferno	Infierno	ğŸ”¥
mountain	MontaÃ±a	â›°ï¸
wind	Viento	ğŸ’¨
stone	Piedra	ğŸª¨
sand	Arena	ğŸœï¸
glass	Vidrio	ğŸªŸ
sea	Mar	ğŸŒŠ
beach	Playa	ğŸ–ï¸
swamp	Pantano	ğŸï¸
volcano	VolcÃ¡n	ğŸŒ‹
geyser	GÃ©iser	â›²
mist	Niebla	ğŸŒ«ï¸
pressure	PresiÃ³n	ğŸ—œï¸
energy	EnergÃ­a	âš¡
earthquake	Terremoto	ğŸŒ‹
tsunami	Tsunami	ğŸŒŠ
sky	Cielo	ğŸŒŒ
sun	Sol	â˜€ï¸
moon	Luna	ğŸŒ•
night	Noche	ğŸŒƒ
time	Tiempo	â³
tree	Ãrbol	ğŸŒ³
forest	Bosque	ğŸŒ²
wood	Madera	ğŸªµ
salt	Sal	ğŸ§‚
primordial_soup	Sopa Primordial	ğŸ¥£
life	Vida	ğŸ§¬
egg	Huevo	ğŸ¥š
animal	Animal	ğŸ¾
bird	PÃ¡jaro	ğŸ¦
fish	Pez	ğŸŸ
lizard	Lagarto	ğŸ¦
dinosaur	Dinosaurio	ğŸ¦–
fossil	FÃ³sil	ğŸ¦´
flower	Flor	ğŸŒ¸
grass	Hierba	ğŸŒ¿
bee	Abeja	ğŸ
honey	Miel	ğŸ¯
tool	Herramienta	ğŸ”§
human	Humano	ğŸ§‘
field	Campo	ğŸŒ¾
farmer	Granjero	ğŸ‘¨â€ğŸŒ¾
livestock	Ganado	ğŸ„
clay	Arcilla	ğŸº
pottery	CerÃ¡mica	ğŸº
bricks	Ladrillos	ğŸ§±
house	Casa	ğŸ 
village	Pueblo	ğŸ˜ï¸
city	Ciudad	ğŸ™ï¸
charcoal	CarbÃ³n	âš«
metal	Metal	âš™ï¸
blade	Hoja	ğŸ”ª
sword	Espada	âš”ï¸
warrior	Guerrero	ğŸ›¡ï¸
blood	Sangre	ğŸ©¸
paper	Papel	ğŸ“œ
writing	Escritura	âœï¸
book	Libro	ğŸ“–
library	Biblioteca	ğŸ“š
knowledge	Conocimiento	ğŸ§ 
civilization	CivilizaciÃ³n	ğŸ›ï¸
electricity	Electricidad	âš¡
lightbulb	Bombilla	ğŸ’¡
engine	Motor	âš™ï¸
car	Coche	ğŸš—
boat	Barco	â›µ
ship	Nave	ğŸš¢
airplane	AviÃ³n	âœˆï¸
computer	Computadora	ğŸ’»
software	Software	ğŸ’¾
internet	Internet	ğŸŒ
ai	IA	ğŸ¤–
robot	Robot	ğŸ¤–
space	Espacio	ğŸš€
spaceship	Nave Espacial	ğŸš€
alien	AlienÃ­gena	ğŸ‘½
ufo	OVNI	ğŸ›¸
story	Historia	ğŸ“–
myth	Mito	ğŸ“œ
magic	Magia	âœ¨
wizard	Mago	ğŸ§™
spell	Hechizo	ğŸª„
potion	PociÃ³n	ğŸ§ª
golem	GÃ³lem	ğŸ—¿
dragon	DragÃ³n	ğŸ‰
phoenix	FÃ©nix	ğŸ¦â€ğŸ”¥
horse	Caballo	ğŸ´
unicorn	Unicornio	ğŸ¦„
mermaid	Sirena	ğŸ§œâ€â™€ï¸
pegasus	Pegaso	ğŸ
death	Muerte	ğŸ’€
undead	No Muerto	ğŸ§Ÿ
zombie	Zombi	ğŸ§Ÿâ€â™‚ï¸
ghost	Fantasma	ğŸ‘»
god	Dios	ğŸ‘‘
angel	Ãngel	ğŸ˜‡
demon	Demonio	ğŸ˜ˆ
heaven	Cielo	â˜ï¸
hell	Infierno	ğŸ”¥
art	Arte	ğŸ¨
music	MÃºsica	ğŸµ
love	Amor	â¤ï¸
dream	SueÃ±o	ğŸ’­
cold	FrÃ­o	ğŸ¥¶
ice	Hielo	ğŸ§Š
glacier	Glaciar	ğŸ”ï¸
avalanche	Avalancha	ğŸŒ¨ï¸
desert	Desierto	ğŸœï¸
oasis	Oasis	ğŸï¸
jungle	Selva	ğŸŒ´
fruit	Fruta	ğŸ
garden	JardÃ­n	ğŸ¡
pollen	Polen	ğŸŒ¼
ink	Tinta	âœ’ï¸
philosophy	FilosofÃ­a	ğŸ¤”
science	Ciencia	ğŸ”¬
scientist	CientÃ­fico	ğŸ‘©â€ğŸ”¬
steam_engine	MÃ¡quina de Vapor	ğŸš‚
factory	FÃ¡brica	ğŸ­
smoke	Humo	ğŸ’¨
smog	Smog	ğŸŒ«ï¸
planet	Planeta	ğŸª
continent	Continente	ğŸ—ºï¸
country	PaÃ­s	ğŸ‡ºğŸ‡³
gold	Oro	ğŸ†
diamond	Diamante	ğŸ’
money	Dinero	ğŸ’°
bank	Banco	ğŸ¦
war	Guerra	ğŸ’¥
army	EjÃ©rcito	ğŸ’‚
gunpowder	PÃ³lvora	ğŸ’£
gun	Pistola	ğŸ”«
soldier	Soldado	ğŸ’‚
king	Rey	ğŸ¤´
queen	Reina	ğŸ‘¸
castle	Castillo	ğŸ°
knight	Caballero	ğŸ›¡ï¸
vampire	Vampiro	ğŸ§›
werewolf	Hombre Lobo	ğŸº
wolf	Lobo	ğŸº
sickness	Enfermedad	ğŸ¤¢
doctor	Doctor	ğŸ‘¨â€âš•ï¸
hospital	Hospital	ğŸ¥
medicine	Medicina	ğŸ’Š
poison	Veneno	â˜ ï¸
rust	Ã“xido	ğŸŸ¤
wave	Ola	ğŸŒŠ
sound	Sonido	ğŸ”Š
imagination	ImaginaciÃ³n	ğŸ’¡
idea	Idea	ğŸ’¡
mind	Mente	ğŸ§ 
soul	Alma	ğŸ‘»
happiness	Felicidad	ğŸ˜Š
sadness	Tristeza	ğŸ˜­
joy	AlegrÃ­a	ğŸ˜‚
sleep	SueÃ±o	ğŸ˜´
ruler	Gobernante	ğŸ‘‘
crown	Corona	ğŸ‘‘
debt	Deuda	ğŸ“‰
peace	Paz	ğŸ•Šï¸
weapon	Arma	ğŸ—¡ï¸
explosion	ExplosiÃ³n	ğŸ’¥
treaty	Tratado	ğŸ¤
ash	Ceniza	ğŸŒ«ï¸
river	RÃ­o	ğŸï¸
bridge	Puente	ğŸŒ‰
textile	Textil	ğŸ§µ
clothing	Ropa	ğŸ‘•
needle	Aguja	ğŸª¡
thread	Hilo	ğŸ§µ
rope	Cuerda	ğŸª¢
sail	Vela	â›µ
pyramid	PirÃ¡mide	ğŸ”º
mummy	Momia	ğŸ§Ÿ
hieroglyphs	JeroglÃ­ficos	ğŸ“œ
papyrus	Papiro	ğŸ“œ
letter	Carta	âœ‰ï¸
mail	Correo	ğŸ“«
email	Email	ğŸ“§
meme	Meme	ğŸ˜‚
sushi	Sushi	ğŸ£
seaweed	Alga	ğŸŒ¿
pizza	Pizza	ğŸ•
cheese	Queso	ğŸ§€
milk	Leche	ğŸ¥›
bread	Pan	ğŸ
flour	Harina	ğŸŒ¾
wheat	Trigo	ğŸŒ¾
alcohol	Alcohol	ğŸ·
wine	Vino	ğŸ·
beer	Cerveza	ğŸº
sake	Sake	ğŸ¶
rice	Arroz	ğŸš
champagne	ChampÃ¡n	ğŸ¾
gas	Gas	ğŸ’¨
caviar	Caviar	ğŸ¥š
sweat	Sudor	ğŸ’¦
steam_cloud	Nube de Vapor	â˜ï¸
blizzard	Ventisca	â„ï¸
snow	Nieve	â„ï¸
robot_dog	Perro Robot	ğŸ¤–ğŸ¶
dog	Perro	ğŸ¶
cat	Gato	ğŸ±
mouse	RatÃ³n	ğŸ­
cheese_wheel	Rueda de Queso	ğŸ§€ğŸŒ€
wheel	Rueda	ğŸ›
cart	Carrito	ğŸ›’
bicycle	Bicicleta	ğŸš²
train	Tren	ğŸš†
locomotive	Locomotora	ğŸš‚
rocket	Cohete	ğŸš€
satellite	SatÃ©lite	ğŸ›°ï¸
telescope	Telescopio	ğŸ”­
microscope	Microscopio	ğŸ”¬
virus	Virus	ğŸ¦ 
bacteria	Bacteria	ğŸ§«
antibiotic	AntibiÃ³tico	ğŸ’Š
vaccine	Vacuna	ğŸ’‰
ant	Hormiga	ğŸœ
spider	AraÃ±a	ğŸ•·ï¸
web	TelaraÃ±a	ğŸ•¸ï¸
honeycomb	Panal	ğŸ¯ğŸ
hexagon	HexÃ¡gono	â¬¡
geometry	GeometrÃ­a	ğŸ“
math	MatemÃ¡ticas	â—
number	NÃºmero	ğŸ”¢
calendar	Calendario	ğŸ“…
clock	Reloj	â°
alarm	Alarma	ğŸš¨
music_box	Caja de MÃºsica	ğŸ¼ğŸ“¦
box	Caja	ğŸ“¦
gift	Regalo	ğŸ
present	Presente	ğŸ
camera	CÃ¡mara	ğŸ“·
film	PelÃ­cula	ğŸï¸
movie	PelÃ­cula	ğŸ¬
actor	Actor	ğŸ­
director	Director	ğŸ¬ğŸ§‘â€ğŸ’¼
popcorn	Palomitas	ğŸ¿
corn	MaÃ­z	ğŸŒ½
pizza_slice	Trozo de Pizza	ğŸ•ğŸ”ª
burger	Hamburguesa	ğŸ”
meat	Carne	ğŸ¥©
sausage	Salchicha	ğŸŒ­
hotdog	Perrito Caliente	ğŸŒ­
soda	Refresco	ğŸ¥¤
ice_cream	Helado	ğŸ¦
cake	Pastel	ğŸ°
cookie	Galleta	ğŸª
chocolate	Chocolate	ğŸ«
owl	BÃºho	ğŸ¦‰
bat	MurciÃ©lago	ğŸ¦‡
wolfpack	Manada de Lobos	ğŸºğŸº
werecat	Hombre Gato	ğŸ±ğŸŒ•
phoenix_egg	Huevo de FÃ©nix	ğŸ¥šğŸ¦â€ğŸ”¥
griffin	Grifo	ğŸ¦…ğŸ¦
lion	LeÃ³n	ğŸ¦
tiger	Tigre	ğŸ¯
bear	Oso	ğŸ»
panda	Panda	ğŸ¼
bamboo	BambÃº	ğŸ
asia	Asia	ğŸ—¾
europe	Europa	ğŸŒ
africa	Ãfrica	ğŸ¦
america	AmÃ©rica	ğŸ¦…
eagle	Ãguila	ğŸ¦…
kangaroo	Canguro	ğŸ¦˜
australia	Australia	ğŸ‡¦ğŸ‡º
island	Isla	ğŸï¸
volcano_island	Isla VolcÃ¡n	ğŸŒ‹ğŸï¸
lava_lamp	LÃ¡mpara de Lava	ğŸª”
mirror	Espejo	ğŸª
magnifying_glass	Lupa	ğŸ”
prism	Prisma	ğŸ”º
light	Luz	ğŸ’¡
shadow	Sombra	ğŸŒ‘
rainbow	ArcoÃ­ris	ğŸŒˆ
storm_cloud	Nube de Tormenta	ğŸŒ©ï¸
tornado	Tornado	ğŸŒªï¸
hurricane	HuracÃ¡n	ğŸŒ€
tsunami_warning	Alerta de Tsunami	ğŸš¨
flood	InundaciÃ³n	ğŸŒŠ
drought	SequÃ­a	ğŸŒµ
cactus	Cactus	ğŸŒµ
rose	Rosa	ğŸŒ¹
treehouse	Casa del Ãrbol	ğŸ¡
log_cabin	CabaÃ±a de Troncos	ğŸšï¸
skyscraper	Rascacielos	ğŸ¢
submarine	Submarino	ğŸš¢ğŸŒŠ
spacesuit	Traje Espacial	ğŸ‘¨â€ğŸš€
alien_plant	Planta AlienÃ­gena	ğŸªğŸŒ±
alien_animal	Animal AlienÃ­gena	ğŸ‘½ğŸ¾
portal	Portal	ğŸŒ€
wizard_hat	Sombrero de Mago	ğŸ§™â€â™‚ï¸ğŸ§¢
spellbook	Libro de Hechizos	ğŸ“–ğŸª„
crystal_ball	Bola de Cristal	ğŸ”®
fairy	Hada	ğŸ§š
goblin	Duende	ğŸ‘º
troll	Trol	ğŸ‘¹
unicorn_horn	Cuerno de Unicornio	ğŸ¦„ğŸ¦´
bone	Hueso	ğŸ¦´ 