# Elements Configuration File
# Format: TSV for simplicity and human-readable maintenance
# Columns: id, name, emoji, recipe (recipe as two IDs, e.g., id1+id2; empty for base elements)
id	name	emoji	recipe
water	Water	ğŸ’§	
fire	Fire	ğŸ”¥	
earth	Earth	ğŸŒ	
air	Air	ğŸŒ¬ï¸	
steam	Steam	ğŸ’¨	water+fire
mud	Mud	ğŸŸ«	earth+water
lava	Lava	ğŸŒ‹	fire+earth
dust	Dust	ğŸŒ«ï¸	air+earth
lightning	Lightning	âš¡	fire+air
cloud	Cloud	â˜ï¸	water+air
rain	Rain	ğŸŒ§ï¸	cloud+water
storm	Storm	â›ˆï¸	lightning+cloud
obsidian	Obsidian	â¬›	lava+water
plant	Plant	ğŸŒ±	mud+air
lake	Lake	ğŸï¸	water+water
inferno	Inferno	ğŸ”¥	fire+fire
mountain	Mountain	â›°ï¸	earth+earth
wind	Wind	ğŸ’¨	air+air
# --- Stage 2: Basic Nature & Materials ---
stone	Stone	ğŸª¨	earth+lava
sand	Sand	ğŸœï¸	stone+wind
glass	Glass	ğŸªŸ	sand+fire
sea	Sea	ğŸŒŠ	lake+water
beach	Beach	ğŸ–ï¸	sea+sand
swamp	Swamp	ğŸï¸	plant+mud
volcano	Volcano	ğŸŒ‹	lava+mountain
geyser	Geyser	â›²	steam+earth
mist	Mist	ğŸŒ«ï¸	cloud+earth
pressure	Pressure	ğŸ—œï¸	air+earth
energy	Energy	âš¡	lightning+fire
earthquake	Earthquake	ğŸŒ‹	earth+energy
tsunami	Tsunami	ğŸŒŠ	sea+earthquake
sky	Sky	ğŸŒŒ	air+cloud
sun	Sun	â˜€ï¸	sky+fire
moon	Moon	ğŸŒ•	sky+stone
night	Night	ğŸŒƒ	sky+moon
time	Time	â³	sand+glass
tree	Tree	ğŸŒ³	plant+time
forest	Forest	ğŸŒ²	tree+tree
wood	Wood	ğŸªµ	tree+tool
salt	Salt	ğŸ§‚	sea+fire
# --- Stage 3: Life Forms ---
primordial_soup	Primordial Soup	ğŸ¥£	sea+lava
life	Life	ğŸ§¬	primordial_soup+lightning
egg	Egg	ğŸ¥š	life+stone
animal	Animal	ğŸ¾	life+earth
bird	Bird	ğŸ¦	animal+air
fish	Fish	ğŸŸ	animal+water
lizard	Lizard	ğŸ¦	egg+swamp
dinosaur	Dinosaur	ğŸ¦–	lizard+time
fossil	Fossil	ğŸ¦´	dinosaur+earth
flower	Flower	ğŸŒ¸	plant+sun
grass	Grass	ğŸŒ¿	earth+plant
bee	Bee	ğŸ	animal+flower
honey	Honey	ğŸ¯	bee+flower
# --- Stage 4: Tools & Humanity ---
tool	Tool	ğŸ”§	stone+wood
human	Human	ğŸ§‘	life+tool
field	Field	ğŸŒ¾	earth+grass
farmer	Farmer	ğŸ‘¨â€ğŸŒ¾	human+field
livestock	Livestock	ğŸ„	animal+farmer
clay	Clay	ğŸº	mud+sand
pottery	Pottery	ğŸº	clay+fire
bricks	Bricks	ğŸ§±	clay+fire
house	House	ğŸ 	bricks+wood
village	Village	ğŸ˜ï¸	house+house
city	City	ğŸ™ï¸	village+village
charcoal	Charcoal	âš«	fire+wood
metal	Metal	âš™ï¸	stone+fire
blade	Blade	ğŸ”ª	metal+tool
sword	Sword	âš”ï¸	blade+wood
warrior	Warrior	ğŸ›¡ï¸	human+sword
blood	Blood	ğŸ©¸	warrior+blade
paper	Paper	ğŸ“œ	wood+pressure
writing	Writing	âœï¸	human+paper
book	Book	ğŸ“–	paper+writing
library	Library	ğŸ“š	book+book
knowledge	Knowledge	ğŸ§ 	book+human
civilization	Civilization	ğŸ›ï¸	city+writing
# --- Stage 5: Technology ---
electricity	Electricity	âš¡	lightning+metal
lightbulb	Light Bulb	ğŸ’¡	electricity+glass
engine	Engine	âš™ï¸	steam+metal
car	Car	ğŸš—	engine+metal
boat	Boat	â›µ	water+wood
ship	Ship	ğŸš¢	boat+metal
airplane	Airplane	âœˆï¸	bird+metal
computer	Computer	ğŸ’»	electricity+tool
software	Software	ğŸ’¾	computer+knowledge
internet	Internet	ğŸŒ	computer+computer
ai	AI	ğŸ¤–	software+life
robot	Robot	ğŸ¤–	ai+metal
space	Space	ğŸš€	sky+moon
spaceship	Spaceship	ğŸš€	airplane+space
alien	Alien	ğŸ‘½	life+space
ufo	UFO	ğŸ›¸	alien+spaceship
# --- Stage 6: Abstract & Mythical ---
story	Story	ğŸ“–	human+book
myth	Myth	ğŸ“œ	story+time
magic	Magic	âœ¨	energy+myth
wizard	Wizard	ğŸ§™	human+magic
spell	Spell	ğŸª„	wizard+writing
potion	Potion	ğŸ§ª	magic+water
golem	Golem	ğŸ—¿	clay+life
dragon	Dragon	ğŸ‰	lizard+fire
phoenix	Phoenix	ğŸ¦â€ğŸ”¥	bird+fire
horse	Horse	ğŸ´	animal+field
unicorn	Unicorn	ğŸ¦„	horse+magic
mermaid	Mermaid	ğŸ§œâ€â™€ï¸	human+fish
pegasus	Pegasus	ğŸ	horse+bird
death	Death	ğŸ’€	life+time
undead	Undead	ğŸ§Ÿ	life+death
zombie	Zombie	ğŸ§Ÿâ€â™‚ï¸	undead+human
ghost	Ghost	ğŸ‘»	undead+air
god	God	ğŸ‘‘	human+time
angel	Angel	ğŸ˜‡	bird+god
demon	Demon	ğŸ˜ˆ	animal+god
heaven	Heaven	â˜ï¸	sky+god
hell	Hell	ğŸ”¥	lava+god
art	Art	ğŸ¨	human+flower
music	Music	ğŸµ	human+wind
love	Love	â¤ï¸	human+human
dream	Dream	ğŸ’­	human+night
# --- Stage 7: Advanced Concepts ---
cold	Cold	ğŸ¥¶	rain+wind
ice	Ice	ğŸ§Š	water+cold
glacier	Glacier	ğŸ”ï¸	mountain+ice
avalanche	Avalanche	ğŸŒ¨ï¸	mountain+wind
desert	Desert	ğŸœï¸	sand+sand
oasis	Oasis	ğŸï¸	desert+water
jungle	Jungle	ğŸŒ´	forest+rain
fruit	Fruit	ğŸ	tree+sun
garden	Garden	ğŸ¡	flower+grass
pollen	Pollen	ğŸŒ¼	flower+wind
ink	Ink	âœ’ï¸	charcoal+water
philosophy	Philosophy	ğŸ¤”	human+knowledge
science	Science	ğŸ”¬	knowledge+tool
scientist	Scientist	ğŸ‘©â€ğŸ”¬	human+science
steam_engine	Steam Engine	ğŸš‚	engine+steam
factory	Factory	ğŸ­	house+tool
smoke	Smoke	ğŸ’¨	fire+wood
smog	Smog	ğŸŒ«ï¸	smoke+mist
planet	Planet	ğŸª	earth+space
continent	Continent	ğŸ—ºï¸	earth+earth
country	Country	ğŸ‡ºğŸ‡³	civilization+continent
gold	Gold	ğŸ†	sun+metal
diamond	Diamond	ğŸ’	pressure+charcoal
money	Money	ğŸ’°	gold+paper
bank	Bank	ğŸ¦	house+money
war	War	ğŸ’¥	country+country
army	Army	ğŸ’‚	warrior+warrior
gunpowder	Gunpowder	ğŸ’£	dust+fire
gun	Gun	ğŸ”«	gunpowder+metal
soldier	Soldier	ğŸ’‚	human+gun
king	King	ğŸ¤´	human+civilization
queen	Queen	ğŸ‘¸	king+love
castle	Castle	ğŸ°	house+king
knight	Knight	ğŸ›¡ï¸	warrior+horse
vampire	Vampire	ğŸ§›	human+blood
werewolf	Werewolf	ğŸº	human+wolf
wolf	Wolf	ğŸº	animal+moon
sickness	Sickness	ğŸ¤¢	human+rain
doctor	Doctor	ğŸ‘¨â€âš•ï¸	human+sickness
hospital	Hospital	ğŸ¥	house+doctor
medicine	Medicine	ğŸ’Š	doctor+plant
poison	Poison	â˜ ï¸	plant+tool
rust	Rust	ğŸŸ¤	metal+water
# --- Stage 8: Deeper Concepts ---
wave	Wave	ğŸŒŠ	wind+lake
sound	Sound	ğŸ”Š	air+wave
imagination	Imagination	ğŸ’¡	human+idea
idea	Idea	ğŸ’¡	human+energy
mind	Mind	ğŸ§ 	human+soul
soul	Soul	ğŸ‘»	human+energy
happiness	Happiness	ğŸ˜Š	human+love
sadness	Sadness	ğŸ˜­	human+rain
joy	Joy	ğŸ˜‚	human+sun
sleep	Sleep	ğŸ˜´	human+night
ruler	Ruler	ğŸ‘‘	human+country
crown	Crown	ğŸ‘‘	metal+gold
debt	Debt	ğŸ“‰	bank+money
peace	Peace	ğŸ•Šï¸	war+human
weapon	Weapon	ğŸ—¡ï¸	tool+blade
explosion	Explosion	ğŸ’¥	gunpowder+fire
treaty	Treaty	ğŸ¤	country+paper
ash	Ash	ğŸŒ«ï¸	fire+plant
river	River	ğŸï¸	mountain+water
bridge	Bridge	ğŸŒ‰	river+wood
textile	Textile	ğŸ§µ	tool+plant
clothing	Clothing	ğŸ‘•	textile+human
needle	Needle	ğŸª¡	metal+textile
thread	Thread	ğŸ§µ	textile+tool
rope	Rope	ğŸª¢	thread+thread
sail	Sail	â›µ	boat+textile
pyramid	Pyramid	ğŸ”º	desert+stone
mummy	Mummy	ğŸ§Ÿ	human+pyramid
hieroglyphs	Hieroglyphs	ğŸ“œ	writing+pyramid
papyrus	Papyrus	ğŸ“œ	plant+river
letter	Letter	âœ‰ï¸	paper+ink
mail	Mail	ğŸ“«	letter+letter
email	Email	ğŸ“§	internet+mail
meme	Meme	ğŸ˜‚	internet+idea
sushi	Sushi	ğŸ£	fish+seaweed
seaweed	Seaweed	ğŸŒ¿	plant+sea
pizza	Pizza	ğŸ•	cheese+bread
cheese	Cheese	ğŸ§€	milk+time
milk	Milk	ğŸ¥›	livestock+grass
bread	Bread	ğŸ	flour+water
flour	Flour	ğŸŒ¾	wheat+stone
wheat	Wheat	ğŸŒ¾	grass+farmer
alcohol	Alcohol	ğŸ·	fruit+time
wine	Wine	ğŸ·	fruit+alcohol
beer	Beer	ğŸº	wheat+alcohol
sake	Sake	ğŸ¶	rice+alcohol
rice	Rice	ğŸš	wheat+water
champagne	Champagne	ğŸ¾	wine+gas
gas	Gas	ğŸ’¨	air+energy
caviar	Caviar	ğŸ¥š	fish+egg
sweat	Sweat	ğŸ’¦	human+sun
steam_cloud	Steam Cloud	â˜ï¸	steam+steam
blizzard	Blizzard	â„ï¸	snow+wind
snow	Snow	â„ï¸	ice+air 